0000000000000000000000000000000000000000000000000
0000000000000000000000000000000000000000000000000
0000000000000000000000000000000000000000000000000
0000000000000000000000000000000000000000000000000
0000000000000000000000000000000000000000000000000
0000000000000000000000000000000000000000000100000
1111111111000111111222222221111133111111111111411
0000000000000000001222222221000133100000001110111
0000000000000000001222222221000133100000000000000
0000000000000000001222222221000133100000000000000
0000000000000000001111111111000111100000000000000